// Lazy load portfolio pages
const TravelBookingEnginePortfolio = lazy(() => import("./pages/portfolio/TravelBookingEngine"));
const HotelBookingEnginePortfolio = lazy(() => import("./pages/portfolio/HotelBookingEngine"));
const CarRentalBookingPortfolio = lazy(() => import("./pages/portfolio/CarRentalBooking"));
const CruiseBookingEnginePortfolio = lazy(() => import("./pages/portfolio/CruiseBookingEngine"));
const BusReservationSystemPortfolio = lazy(() => import("./pages/portfolio/BusReservationSystem"));
const ActivitiesBookingPortfolio = lazy(() => import("./pages/portfolio/ActivitiesBooking"));
const VacationRentalManagementPortfolio = lazy(() => import("./pages/portfolio/VacationRentalManagement"));
const FlightBookingEnginePortfolio = lazy(() => import("./pages/portfolio/FlightBookingEngine"));
const B2BTravelPortalPortfolio = lazy(() => import("./pages/portfolio/B2BTravelPortal"));
const B2CTravelPortalPortfolio = lazy(() => import("./pages/portfolio/B2CTravelPortal"));
const CustomTravelPortalPortfolio = lazy(() => import("./pages/portfolio/CustomTravelPortal"));
const HotelExtranetPortfolio = lazy(() => import("./pages/portfolio/HotelExtranet"));
const NDCAPIIntegrationPortfolio = lazy(() => import("./pages/portfolio/NDCAPIIntegration"));
const AmadeusAPIIntegrationPortfolio = lazy(() => import("./pages/portfolio/AmadeusAPIIntegration"));
const SabreAPIIntegrationPortfolio = lazy(() => import("./pages/portfolio/SabreAPIIntegration"));
const GDSIntegrationPortfolio = lazy(() => import("./pages/portfolio/GDSIntegration"));
const ElectronJSDevelopersPortfolio = lazy(() => import("./pages/portfolio/ElectronJSDevelopers"));
const ReactJSDevelopersPortfolio = lazy(() => import("./pages/portfolio/ReactJSDevelopers"));
const NextJSDevelopersPortfolio = lazy(() => import("./pages/portfolio/NextJSDevelopers"));
const HTMLDevelopersPortfolio = lazy(() => import("./pages/portfolio/HTMLDevelopers"));
const AngularDevelopersPortfolio = lazy(() => import("./pages/portfolio/AngularDevelopers"));
const GatsbyJSDevelopersPortfolio = lazy(() => import("./pages/portfolio/GatsbyJSDevelopers"));
const NodeJSDevelopersPortfolio = lazy(() => import("./pages/portfolio/NodeJSDevelopers"));
const LaravelDevelopersPortfolio = lazy(() => import("./pages/portfolio/LaravelDevelopers"));
const PythonDevelopersPortfolio = lazy(() => import("./pages/portfolio/PythonDevelopers"));
const NestJSDevelopersPortfolio = lazy(() => import("./pages/portfolio/NestJSDevelopers"));
const ExpressJSDevelopersPortfolio = lazy(() => import("./pages/portfolio/ExpressJSDevelopers"));
const DotNetDevelopersPortfolio = lazy(() => import("./pages/portfolio/DotNetDevelopers"));
const GolangDevelopersPortfolio = lazy(() => import("./pages/portfolio/GolangDevelopers"));
const AndroidAppDevelopersPortfolio = lazy(() => import("./pages/portfolio/AndroidAppDevelopers"));
const ReactNativeDevelopersPortfolio = lazy(() => import("./pages/portfolio/ReactNativeDevelopers"));
const FlutterDevelopersPortfolio = lazy(() => import("./pages/portfolio/FlutterDevelopers"));
const KotlinDevelopersPortfolio = lazy(() => import("./pages/portfolio/KotlinDevelopers"));
const SwiftDevelopersPortfolio = lazy(() => import("./pages/portfolio/SwiftDevelopers"));
const iOSDevelopersPortfolio = lazy(() => import("./pages/portfolio/iOSDevelopers"));
const BookingAppSolutionsPortfolio = lazy(() => import("./pages/portfolio/BookingAppSolutions"));
const ChatbotSolutionsPortfolio = lazy(() => import("./pages/portfolio/ChatbotSolutions"));
const FoodDeliverySolutionsPortfolio = lazy(() => import("./pages/portfolio/FoodDeliverySolutions"));
const VideoStreamingSolutionsPortfolio = lazy(() => import("./pages/portfolio/VideoStreamingSolutions"));
const ELearningSolutionsPortfolio = lazy(() => import("./pages/portfolio/ELearningSolutions"));
const HRMSSolutionsPortfolio = lazy(() => import("./pages/portfolio/HRMSSolutions"));
const ARAppDevelopmentPortfolio = lazy(() => import("./pages/portfolio/ARAppDevelopment"));
const DataEngineeringPortfolio = lazy(() => import("./pages/portfolio/DataEngineering"));
const DataAnalyticsPortfolio = lazy(() => import("./pages/portfolio/DataAnalytics"));
const DataVisualizationPortfolio = lazy(() => import("./pages/portfolio/DataVisualization"));
